4 5
#########
#o......#
#.......#
#o.v.c.c#
#.......#
#v......#
#########