4 5
#########
#a.....o#
#.......#
#......c#
#.......#
#a......#
#########