4 5
#########
#c.....v#
#.......#
#c.v...p#
#.......#
#o.o...p#
#########