4 5
#########
#c.v.p.p#
#.......#
#.......#
#.......#
#c.v.o.o#
#########