4 5
#########
#v.p.p.c#
#.......#
#..o.o..#
#.......#
#v.....c#
#########