4 5
#########
#o......#
#.......#
#..v....#
#.......#
#....o.v#
#########