4 5
#########
#p.o.o..#
#.......#
#p.c....#
#.......#
#c......#
#########
