4 5
#########
#a...a.a#
#.......#
#o.p....#
#.......#
#....a.c#
#########