4 5
#########
#a.a...v#
#.......#
#......a#
#.......#
#p...c..#
#########