4 5
#########
#o.....p#
#.......#
#..c.p..#
#.......#
#o.....c#
#########