4 5
#########
#c.....v#
#.......#
#.......#
#.......#
#a.a.a.o#
#########