4 5
#########
#v.a.p..#
#.......#
#....o.a#
#.......#
#......a#
#########