4 5
#########
#c.....c#
#.......#
#p.v.v.o#
#.......#
#p.....o#
#########