4 5
#########
#a.a....#
#.......#
#....v.c#
#.......#
#.......#
#########