4 5
#########
#......c#
#.......#
#c.v.o.o#
#.......#
#......v#
#########
