4 5
#########
#..c.p.p#
#.......#
#....c.o#
#.......#
#......o#
#########