4 5
#########
#o.o.p.p#
#.......#
#.......#
#.......#
#c.....c#
#########
