4 5
#########
#..p.o..#
#.......#
#p......#
#.......#
#o......#
#########
