4 5
#########
#v.p.p..#
#.......#
#....v..#
#.......#
#....c.c#
#########