4 5
#########
#c.....c#
#.......#
#v.....p#
#.......#
#v.....p#
#########
