4 5
#########
#..v...p#
#.......#
#..v...p#
#.......#
#..o...o#
#########