4 5
#########
#a...a.a#
#.......#
#....p..#
#.......#
#....c.v#
#########