4 5
#########
#..v.o.o#
#.......#
#v.p.c..#
#.......#
#..p...c#
#########