4 5
#########
#..c.v..#
#.......#
#.......#
#.......#
#..c.v..#
#########