4 5
#########
#v...a.a#
#.......#
#....a..#
#.......#
#c.....o#
#########