4 5 
#########
#p.o.o.v#
#.......#
#p...c.v#
#.......#
#c......#
#########